NO ./D-textures/kacm9.xpm
SO ./D-textures/kacm6.xpm1706189828.xpm
WE ./D-textures/kacm51706189758.xpm
EA ./D-textures/kacm41706189329.xpm
F   139,90, 43
C  135, 206, 235


        1111111111111111111111111
        1000000000110000000000001
        101100000111000000W000001
        1001000000000000000000001
111111111011000001110000000000001
100000000011000001110111111111111
11110111111111011100000010001
11111111111111011101010010001
11000000110101011100000010001
10000000000000001100000010001
1000000000000001101010011101
1000000000000001101010011101
1000000000000001101010011101
1000000000000001101010011101
1000000000000001101010011101
1000000000000001101010011101
1000000000000001101010011101
1000000000000001101010011101
1000000000000001101010011101
1000000000000001101010011101
1000000000000001101010011101
1000000000000001101010011101
1000000000000001101010011101
1000000000000001101010011101
1111111111111111111111111111
