NO ./D-textures/no.xpm
SO ./D-textures/so.xpm
WE ./D-textures/we.xpm
EA ./D-textures/ea.xpm
DOOR ./D-textures/door.xpm
F 139,90,43
C 135,206,235

        1111111111111111111111111
        1000000000110000000000001
        1011000001110000000000001
        10010000000D0000000000001
1111111110110000011100000N00000001
10000000001100000111D111111111111
11110111111111D11100000010001
1111D111111111011101010010001
11000000110101011100000010001
10000000000000001100000010001
100000000000000011010100111D1
11000001110101011111D1111100111
11110111 1110101 100011000001
11111111 1111111 111111111111
